1111111
1011C11
100-001
1C|0011
100PC11
1E00001
1111111
