111111111111111111111111111111
1111-0001100111111100000000011
1111000C00000C11111000C0000011
111000000000000001100000001011
1110000000000-00000000000000C1
1111111111111111111C0000000011
100000000000000000000111110C01
100111111111111111111111111101
1000000000000-0000000000000001
1000000000011111110000000C1111
1111111C0001111111111111111111
1000C0000000000000000000000001
100000000011111111100000000001
100000000011111111000000C00001
10-000000111111111100000000001
1000000000000P1000010000001111
100000000000000000000000001111
111110000000000000000000000001
1111000000000000111111100000C1
111000000001100011111110000001
111000001111100011111110001111
110001111000000000C11110001111
111C000000000C0000000000-00011
100000000000000000000000001111
10-0000111111000000111100111C1
100000011111100000011110011101
100000011111100000111110111101
100110000000000111111110100001
1E011000111111000000000-000011
111111111111111111111111111111
